3
8 5 3 4
1 8 5 5 1 2 6 7
5
1 3 2 1 3 1 4 1 1 2
7 4 4 4
1 7 5 5 1 2 6 3
4
4 3 3 1 2 2 3 1
5 1 1 1
1 2
5
3 2 2 1 3 3 2 4 3 1